111111111111111
125555555555521
101010101010101
155555555555551
101010101010101
155555555555551
101010101010101
155555555555551
101010101010101
155555555555551
101010101010101
155555555555551
101010101010101
125555555555521
111111111111111
