111111111111111
125000550530521
151010141010151
105504450000401
101015101510131
130000550500001
151410141015101
100550500550051
101314141510101
150503305000051
151010141015101
155350500500501
151013101510151
125530500030521
111111111111111
