111111111111111
125000504053521
151315141015151
105544450500001
151310101013101
104005054050041
151514151514141
100055045530001
101515101010151
100500045543001
151015151510101
135303505305541
151010101014151
125055550040521
111111111111111
