111111111111111
125500530550521
151510151314151
130050050300001
101510151315151
100540055550401
101014101510151
150003555450001
151510101015141
100000544550401
141514101510101
103300030003541
151013131315151
125050050500521
111111111111111
