111111111111111
125034044555521
151515131514151
103055405000001
101010141515151
105005050544001
101510101514151
150000455000341
101010131010151
104000504554501
151010151515151
154050505000501
151014151413151
125040000550521
111111111111111
