111111111111111
125050000505521
151015151015151
150055000005031
141010141010141
150000500505051
141513101515101
100055503450501
141510151310101
105300550055001
141013151010141
154055503000041
151510101010151
125000005050521
111111111111111
